{
  "account_id": {
    "strategy": "high_as_mid",
    "top_categories": [
      "ID000572995",
      "ID000423585",
      "ID000250969",
      "ID000720641",
      "ID000207304",
      "ID000122678",
      "ID000762263",
      "ID000112236",
      "ID000783129",
      "ID000448931"
    ]
  }
}