{
  "account_id": {
    "strategy": "high_as_mid",
    "top_categories": [
      "ID000123534",
      "ID000034328",
      "ID000938073",
      "ID000373053",
      "ID000320193",
      "ID000093551",
      "ID000367141",
      "ID000097900",
      "ID000488225",
      "ID000092917"
    ]
  }
}