{
  "account_id": {
    "strategy": "high_as_mid",
    "top_categories": [
      "ID000289647",
      "ID000073857",
      "ID000605852",
      "ID000235012",
      "ID000749419",
      "ID000927557",
      "ID000625377",
      "ID000086203",
      "ID000373078",
      "ID000078758"
    ]
  }
}